11111
1C001
10001
10P01
1DDD1
10E01
11111