11111111111111111
100000000C0000001
100C000010000D001
10000000000000001
1000000P000000001
10000000000000001
10111111111111101
10000000000000011
100DE000001000001
10C0D0000000C0001
10000000000000001
100000D0000000001
11111111111111111