11111
1C001
10001
10P01
11111
10E01
11111