11111
1C001
10P01
10E01
11111
