11111111111111111
100000000C0000001
100C0000100000001
10000000000000001
1000000P000000001
10000000000000001
10111111111111101
10000000000000011
1000E000001000001
10C00000000C00001
10000000000000001
10000000000000001
11111111111111111