11111
10001
10001
1C001
10001
10001
10P01
10001
10001
10E01
10001
10001
11111